After=potom
AfterCrossroad=za křižovatkou
AfterEnd=za koncem
AfterJunction=za odbočkou
AfterTheSign=za značkou
AfterTheSigns=za značkami
And=a
AroundBale=okolo balíku
AroundBarrel=okolo sudu
AroundPole=okolo sloupu
AroundSign=okolo značky
AroundSigns=okolo značek
AroundTyres=okolo pneumatik
Asphalt=asfalt
AtJunction=na odbočce
AtTheBale=u balíku
AtTheBarrel=u sudu
AtTheCrossroad=na křižovatce
AtTheGate=u brány
AtTheHouse=u domu
AtThePoles=u sloupů
AtTheRail=u zábradlí
AtTheRoundabout=na kruháči
AtTheSign=u značky
AtTheSigns=u značek
AtTheTyres=u pneumatik
BadCamber=špatný náklon
Bale=balík
Barrel=sud
BigCrest=velký horizont
BigCut=velký střih
BigDip=velký propad
Blind=slepé
Brake=brzdit
Bridge=most
Bump=nerovnost
Bumps=nerovnosti
Caution=pozor
CautionInside=pozor vnitřek
CautionOutside=pozor venek
Chicane=šikana
Cobbles=kostky
Concrete=beton
Crest=horizont
Crossroad=křižovatka
Cut=střih
CutIn=střih dovnitř
Dip=propad
Dist100=sto
Dist130=sto třicet
Dist150=sto padesát
Dist170=sto sedmdesát
Dist200=dvě stě
Dist250=dvě stě padesát
Dist300=tři sta
Dist350=tři sta padesát
Dist40=čtyřicet
Dist400=čtyři sta
Dist50=padesát
Dist60=šedesát
Dist70=sedmdesát
Dist80=osmdesát
Dist90=devadesát
Ditch=příkop
DitchInside=příkop vnitřek
DitchOutside=příkop venek
Dont=ne
DontCut=nestříhej
Down=z kopce
Downhill=z kopce
Early=brzy
Finish=cíl
FlatCrest=plochý horizont
FlatOut=plnej
Ford=brod
Gate=brána
GoLeft=vlevo
GoRight=vpravo
GoStraight=rovně
Gravel=šotolina
Handbrake=ručka
HeavyBrake=silně brzdit
Hidden=skryté
Hole=díra
Holes=díry
Ice=led
Immediate=hned
Inside=vnitřek
Into=do
IntoDip=do propadu
Jump=skok
JumpBig=velký skok
JumpMaybe=možná skok
JumpSmall=malý skok
Junction=odbočka
KeepIn=drž vnitřek
KeepLeft=drž vlevo
KeepMiddle=drž střed
KeepOut=drž venek
KeepRight=drž vpravo
Kinks=esíčka
KinksStartingLeft=esíčka začínají levá
KinksStartingRight=esíčka začínají pravá
Late=pozdě
Left1=levá jedna
Left2=levá dvě
Left3=levá tři
Left4=levá čtyři
Left5=levá pět
Left6=levá šest
LeftAcuteHP=levá ostrá vracečka
LeftChicane=levá šikana
LeftChicaneEntry=vjezd do levé šikany
LeftFlat=levá plná
LeftHP=levá vracečka
LeftKink=levý kink
LeftOpenHP=levá otevřená vracečka
LeftRight=levá pravá
LeftSquare=levá čtverec
Logs=klády
LogsInside=klády vnitřek
LogsOutside=klády venek
Long=dloooouhá
LongMale=dloooouhá
LongStraight=dloooouhá rovina
Loose=volno
LooseGravel=volná šotolina
Minus=mínus
Mud=bláto
Narrows=zúžení
NarrowsInside=zúžení vnitřek
NarrowsLeft=zúžení vlevo
NarrowsOutside=zúžení venek
NarrowsRight=zúžení vpravo
OnAsphalt=na asfaltu
OnCobbles=na kostkách
OnConcrete=na betonu
OnGravel=na šotolině
OnIce=na ledu
OnLooseGravel=na volné šotolině
OnPavement=na dlažbě
OnSnow=na sněhu
OnSnowAndIce=na sněhu a ledu
Opens=otevírá se
OpensLate=otevírá se pozdě
Outside=venek
Over=přes
OverBigJump=přes velký skok
OverBridge=přes most
OverBump=přes nerovnost
OverBumps=přes nerovnosti
OverCrest=přes horizont
OverDip=přes propad
OverJump=přes skok
OverJumpSmall=přes malý skok
Pavement=dlažba
Plus=plus
Pole=sloup
Pothole1=díra
Pothole2=díra
Potholes1=díry
Potholes2=díry
Right1=pravá jedna
Right2=pravá dvě
Right3=pravá tři
Right4=pravá čtyři
Right5=pravá pět
Right6=pravá šest
RightAcuteHP=pravá ostrá vracečka
RightChicane=pravá šikana
RightChicaneEntry=vjezd do pravé šikany
RightFlat=pravá plná
RightHP=pravá vracečka
RightKink=pravý kink
RightLeft=pravá levá
RightOpenHP=pravá otevřená vracečka
RightSquare=pravá čtverec
Rock=kamen
Rocks=kamínky
RocksInside=kamínky vnitřek
RocksOutside=kamínky venek
Rough=rozbitý povrch
Roundabout=kruháč
Ruts=koleje
Short=krátká
ShortMale=krátká
Sign=značka
Signs=značky
Slippery=kluzko
SlowDown=zpomal
SmallCrest=malý horizont
SmallCut=malý střih
Snow=sníh
SnowAndIce=sníh a led
StopAtMarshals=zastav u pořadatelů
Sudden=najednou
SuddenLeft=najednou levá
SuddenRight=najednou pravá
Threes=trojky
ThreesInside=trojky vnitřek
ThreesOutside=trojky venek
ThroughGate=skrze bránu
ThroughTunnel=skrze tunel
ThroughWater=skrze vodu
Tighten1=utahuje jedna
Tighten2=utahuje dvě
Tighten3=utahuje tři
Tighten4=utahuje čtyři
Tighten5=utahuje pět
Tightens=utahuje
TightensLate=utahuje pozdě
Tree=strom
TreeInside=strom vnitřek
TreeOutside=strom venek
Tunnel=tunel
Tyres=pneumatiky
UnderBridge=pod mostem
Up=do kopce
UpHill=do kopce
VeryLong=velmi dlouhá
VeryLongStraight=velmi dlouhá rovina
Water=voda
WaterSplash=brod
Wet=mokro
Widens=rozšiřuje se
WidensInside=rozšiřuje se vnitřek
WidensLeft=rozšiřuje se vlevo
WidensOutside=rozšiřuje se venek
WidensRight=rozšiřuje se vpravo
Yes=jo
